1111111111111
1C000000000E1
1111111111101
100001C0000P1
1111111111101
111111111C001
1111111111111
