1111111111111111111111111
10001000000000000010000P1
1010101010000111011000011
1010100010101001010001001
1010100011101100010011001
1100000010001000011010001
1000010110001001000100011
101000100101011E010000001
10010110101000C1001110101
1000001010101101000000001
1011001010101000001001001
1000100000100001001001001
1111111111111111111111111