1111111111111111111
111111111E111111111
1111111110111111111
1C0000000P0000000C1
1111111110111111111
1111111110111111111
1111111111111111111