1111111111111
1C100000000E1
1001C11111001
100001C0000P1
1111111111111
