1111111111111
1E100000CC0C1
1001011111001
100C01C0000P1
1111111111111
