1111111111111111111
10000000C0000001111
1001011111000001111
10010000C0000001111
1001000000000E01111
1PP0111110110000PC1
1111111111111111111