1111111111111
1C101000000P1
1C01000000001
100000000E001
1111111111111