11111
1E001
100011
1P0C11
111111