1111111111111
1C101000000P1
1C01000000001
1X0000X00E001
1111111111111