111111111111111111111111111111
1C00000000000000000011111000P1
1CC000000000000000001111100001
1CCC00000000000000001111100001
1000C0000000000000001111100001
10000C000000000000001111100001
100000C00000000000001111100001
100000000000000000001111100001
100000000000000000001111100001
1E0000000000000000001111100001
111111111111111111111111111111